WHO	Regular Class Time	Song Title	Artist
Ballet 1/Tap 1 Combo Ballet	Mon 4:15pm (Marissa)	'Journey to the Past', 'Christy Altomare'
Ballet 1/Tap 1 Combo Tap	Mon 4:15pm (Marissa)	'Live Your Story', 'Tina Parol'
Ballet 1	Mon 5:15pm (Marissa)	'Touch the Sky (Instrumental)', 'Roxane Genot, Jan Prouska'
Lyrical/Modern 1	Mon 6:15pm (Marissa)	'Home', 'Phillip Phillips'
PreBallet & PreAcro A 	Wed 10:00am (Marissa)	'Wind in My Hair', 'Rapunzel'
PreBallet & PreAcro A Ballet	Wed 10:00am (Marissa)	'Little Wonders', 'Rob Thomas'
PreBallet & PreTap C	Wed 11:00am (Marissa)	'Under the Sea', 'The Little Mermaid'
PreBallet & PreTap C	Wed 11:00am (Marissa)	'My Wish', 'Rascal Flats'
PreBallet & PreTap D	Thurs 11:00am (Marissa)	'Under the Sea', 'The Little Mermaid'
PreBallet & PreTap D	Thurs 11:00am (Marissa)	'My Wish', 'Rascal Flatts'
PreBallet & PreTap E	Thurs 4:15pm (Marissa)	'Butterfly Fly Away', 'Miley and Billy Ray Cyrus'
PreBallet & PreTap E	Thurs 4:15pm (Marissa)	'When Will My Life Begin', 'Mandy Moore'
Musical Theater 1	Thurs 5:15pm (Marissa)	'Come Alive', 'The Greatest Showman'
Jazz 1	Thurs 6:15pm (Marissa)	'Stand Out', 'Tevin Campbell'
Jazz 2	Mon 6:15pm (Angie)	'Spaceman', 'Head Up High'
Adult Tap 1	Mon 7:15pm (Angie)	'The Feeling', 'Sammy Rae & Friends'
Ballet 1/Tap 1 Combo Ballet	Wed 2:30pm (Angie)	'Stand By Me', 'Florence + the Machine'
Ballet 1/Tap 1 Combo Tap	Wed 2:30pm (Angie)	'A Wink and a Smile', 'Harry Connick, Jr.'
Tap 1	Wed 4:15pm (Angie)	'New York, New York', 'Home State and Yellsmiles/Anna Uzele & Original Broadway Cast 2024'
Tap 2	Wed 5:15pm (Angie)	'Welcome to New York (Taylor''s Version)', 'Taylor Swift'
Tap 3	Wed 6:15pm (Angie)	'Jet Set', 'Catch Me If You Can -- Aaron Teveit & Company of the Original Broadway Cast 2011'
Adult Tap 2	Wed 7:15pm (Angie)	'No Excuses', 'Meghan Trainor'
PreBallet & PreAcro B Ballet	Thurs 11:00am (Angie)	'Mon Coeur Fait Vroum (My Heart Goes Vroom)', 'Cars 2 - BÃ©nabar'
PreBallet & PreAcro B Tap	Thurs 11:00am (Angie)	'Daughter', 'Ben Rector'
Lyrical/Modern 1	Thurs 4:15pm (Angie)	'How It Ends', 'DeVotchKa'
Lyrical/Modern 2	Thurs 5:15pm (Angie)	'You Will Be Found', '"Dear Evan Hansen" Original Motion Picture Soundtrack'
Ballet 1/Tap 1 Combo Ballet	Tues 4:15pm (Jillian)	'Dream', 'Priscilla Ahn'
Ballet 1/Tap 1 Combo Tap	Tues 4:15pm (Jillian)	'Ease On Down the Road', 'Matthew Morrison'
Ballet 1	Tues 5:15pm (Jillian)	'Belle of the Ball', 'Leroy Anderson, Simon Tedeschi, Paul Mann'
Ballet 2	Tues 6:15pm (Jillian)	'Sleeping Beauty Waltz', 'Tchaikovsky, London Symphony Orchestra'
Musical Theater HS	Tues 7:15pm (Jillian)	'Another Day of Sun', 'La La Land Cast'
PreBallet & PreTap A Ballet	Wed 10:00am (Jillian)	'Singin'' in the Rain', 'JJ Heller'
PreBallet & PreTap A Tap	Wed 10:00am (Jillian)	'Lollipop', 'Sophie Green'
PreBallet & PreTap B Ballet	Wed 11:00am (Jillian)	'la la lu', 'Christina Perri'
PreBallet & PreTap B Tap	Wed 11:00am (Jillian)	'My Kind of Girl', 'Buddy Greco'
Acro 1	Tues 4:15pm (Emilee)	'You''ll Always Find Your Way Back Home', 'Hannah Montana'
Acro 2	Tues 5:15pm Emilee)	'He''s A Pirate', 'Dimitri Vegas & Like MIke'
HS Ballet & Contemp	Wed 6:15pm (Emilee)	'Wings', 'Little Mix'
Adult Ballet & Contemp	Wed 7:15pm (Emilee)	'Rise Up', 'Andra Day'
Musical Theater 2	Wed 4:15pm (Emilee)	'Broadway Baby', 'Glee Cast'
Acro Jr	Wed 5:15pm (Emilee)	'Hawaiian Roller Coaster Ride', 'Jump5'
Acro 3	Wed 6:15pm (Emilee)	'Waka Waka (This Time for Africa)', 'Shakira'
Musical Theater 3	Wed 7:15pm (Emilee)	'Defying Gravity', 'Wicked: The Soundtrack, Wicked Movie Cast'
SpecTapular	All Tap Classes	'Song-A-Long', 'Cast of Eurovision Song Contest: The Story of Fire Saga'
